111111111111111111111
1p0000000c00000000001
100000011110000000001
111111110010000000001
1000000000c0001000001
1000000000c0000000001
100000000010000000001
100000000010001100001
10000cc000100011000e1
111111111111111111111
